# **************************************************************************** #
#                                                                              #
#                                                         :::      ::::::::    #
#    boss.cub                                           :+:      :+:    :+:    #
#                                                     +:+ +:+         +:+      #
#    By: jgambard <marvin@42.fr>                    +#+  +:+       +#+         #
#                                                 +#+#+#+#+#+   +#+            #
#    Created: 2020/02/16 12:47:18 by jgambard          #+#    #+#              #
#    Updated: 2020/02/16 14:16:26 by jgambard         ###   ########lyon.fr    #
#                                                                              #
# **************************************************************************** #

#SET RESOLUTION
R 800 800

#SET TEXTURES
NO textures/icy_wall.xpm
SO textures/icy_wall.xpm
WE textures/icy_wall.xpm
EA textures/icy_wall.xpm
S textures/pine.xpm

#SET COLORS
#F      240,     240,   240
F textures/stone_floor.xpm
#C 100,100,255
C textures/halloween_sb.xpm  

#MAP
1111111111111111111111111
1000000000000000000000001
1000000000000002000000001
1000002400000000000002001
1000000100000000400000001
1000000100000000110000001
1000000000000000000000001
1000000000000000000000001
1000000000000000000000001
1000011000000000001000001
1000000000000000001000001
1000002000005000000000001
1000000000000000000020001
1000000100000000000000001
1000000100000000040000001
1000000000000000100000001
1000000000000000100000001
1000300000000000000000001
1000011000000000000000001
1000000000000000000000001
1000000000000000000002001
100000000000N000000000001
1111111111111111111111111
